10
# # # # # # # # # #
. . # . # # # . . #
# . # . . # # . # #
# . # # . . . . # #
# . # # . # . # . .
# . . # . # . # . #
# # . # . # . # . #
# # . # . # . # . #
# . . . . # . . . #
# # # # # # # # # #
